11111111111111
10000000C00001
11110000101001
100P0000010001
10000EC0100001
11111111111111
