1111111111
1000000001
1111000011
1000000001
1000PE0001
1000000011
1111111111
1000000001
100000C001
1000000011
1111111111
