1111111111
10000000C1
1111000011
100P000001
100C000001
10000EC011
1111111111
